11111111111
12001314001
10001011101
10111010101
10000000001
15001110011
11111111111