11111111111
10000000051
10011111111
12011111111
10011111111
10000000041
11111111111