11111111111
11050141011
11010101011
12000000031
11110111011
11110111011
11111111111