111111111111111
100013140000001
100010111111001
101010100001001
101110100001001
100000100000011
100011100000111
111000000011111
150000000000001
111111111111111