11111111111
12000000031
10110100011
10000100001
11100101001
15000000041
11111111111